Tsar	ツァーリ	ロシア等スラヴ圏の君主
Blue Sand	青い砂	用語テストで入力
Cierzo	シエルゾ	Cierzoシエルゾはスペインの北から吹く猛烈なからっ風
Monsoon	モンスーン	Monsoonモンスーンは季節によって向きの変わる風(季節風)
Travel Ration	旅糧	Elonaから引用。旅用の糧食。
Sprint	ダッシュ
knocked back	ノックバック
knocked down	ノックダウン
Health	体力
Dodging	ドッジロール	回避行動。ロールを付けたほうが転がって回避することが伝わりやすいと思ったためこの訳文とした。
Stability	スタビリティー	直接的な意味からは外れますが、個人的には流行りの隻狼に乗っかって体幹でもいいかなと思います。
Bar	バー	体力バーとかのバー。ゲージでもいいかも。
Needs	欲求
Cabal of Winds	風の一党
Boon	恵み	バフみたいなの？
Flint and Steel	火打石と打ち金
Kit	道具
Kitchen	キッチン
Cooking Pot	料理鍋
Main Hand	右手
Off Hand	左手
Guarding	警戒	休息時に敵の奇襲の可能性を減らす
Aurai	オーライ	地名？
Yzan	イザン	旧友。船で共に遠征に行く。難破後、主人公に親切にしてくれる。いいやつ
waterskin	水袋	革の水筒。
Gaberries	ギャベリー	ゲーム内のキイチゴ的な食料。
Gaberry	ギャベリー	ゲーム内のキイチゴ的な食料。
silver	銀貨	銀製の貨幣。
Guards	衛兵	場面によって「衛兵」と直訳で問題ないか例外的に「おい、誰か！」などとするか別れそう
Etheral	エーテル
Lightning	稲妻
Decay	腐敗または減衰	既に既存翻訳部分で差異がある模様
Trog spawn	疫病神	主人公一族のことっぽい。部族に災いをもたらす系の人？
Blood Price	血の代償	この分だけ金を払わんといかんらしい
Chamberlady	議員の女性	議会とか政治関連の女性の意味合い？
the Blue Chamber	青の議会	あくまで暫定翻訳で。
the Blue Chamber Collective	青の議会	青の議会と言い方がちがうけど多分一緒もんでしょう
guard duty	守護税	村の安全の為の税金？
Blister Burrow	ブリスターブロウ	シエルゾの北東にある
Helen Turnbull	ヘレン・ターンベル	シエルゾにいる珍しい物好きの女性。
ceviche	セビチェ	ラテンアメリカで食される魚介類のマリネ
Orochi	オロシ	ゲーム内の土地名。颪、山から吹き下ろす風のこと。
Alchemy Kit	錬金術キット	ItemID5010200
Holy Mission	聖なる任務	詳細はまだよく分からん
I refuse to consider being part of it	メモ参照	オリエールのセリフに関してメモ。シエルゾの代表としての役割につけと母に言われたという意味合い？
Scourge	スカージ	スカージの獣、とかで使われてる単語。たぶんモンスター的なものか、宗教的な悪の総称？
Pilgrim Road	巡礼者の道
General Store	雑貨屋	おつかい先。帳簿を届ける
Sun-Pillars	太陽の柱	たぶん地名？
Beast Golem scraps	ビーストゴーレムのスクラップ	ItemID6600130
Manticore Tail	マンティコアの尾	ItemID6600150
Shark Cartilage	鮫の軟骨	ItemID6600170
Mushroom Shield	キノコの盾	ItemID2300150
Conflux Mountain	コンフラックス山	最初のマップの中央にある紫の山
Alchemist	錬金術師
Chersonese	チェルソネス	既存翻訳部分より
Chersonese	ケールサニース	ギリシャ語で「乾いた島」=半島のこと
Conflux	合流点	「カナメ」とか「辻」とか真ん中を感じさせる言葉かな
Corrupted Tombs	退廃の墓地	Chersoneseの地名
Enmerkar	エンメルカル	シュメール人の王。ギルガメシュの3代前にあたる。伝説上の人物？
Hallowed Marsh	聖なる沼	沼？沢？
Light Spire	光の塔	Hallowed Marshにある。Gold Mask Lichが居る。
Gold-Mask Lich	金面のリッチ	Hallowed MarshのLight Spireにいる
Dark Ziggurat	闇のジッグラト	Hallowed Marshにある。Jade-Mask Lichが居る。
Jade-Mask Lich	ヒスイ面のリッチ	Hallowed MarshのDark Zigguratにいる
Campfire	キャンプファイヤー
Tsar Stone	ツァーリの宝玉	ItemID6200010
Hackmanite	ハックマナイト	ItemID6200130
Palladium	パラジウム	ItemID6400070
Necropolis	ネクロポリス	古代の共同墓地を指したり、単にゴーストタウンを指す場合もある
impact	打撃	衝撃とかでもありかもしれないが...
dodge	ドッジロール	前転するのでロールを入れたほうがわかりやすいかと
Roland	ローランド	イザンの兄弟、若くみえるので弟か？
Campfire Kit	キャンプファイヤーキット
Power Coil	電源用コイル	Power Inductorとも。供給される電源から高周波成分を除去し、ノイズの少ない純粋な直流に近づけるための回路素子。
Writ of Tribal Favor	一族の支持の証	構成員を助けることでその人が所属する団体からの支持を示す書状をもらえる。
Levant	レバント	El Levanteエル・レヴァンテ(スペイン語で東)は地中海に吹く東風
Berg	ベルク	バーグウインド(アフリカーンス語で山の風)は南アフリカの高地から海へ下る熱風
Oliele	オリエル	リッサの娘？
Aberdeen	アバディーン	リッサ、オリエールの血統
Vendavel	ヴェンダヴェル	vendavalとも。ジブラルタル海峡近辺で冬に吹く東風
Rospa	ロスパ	おそらく海賊の頭目。ロスパ船長とか呼ばれてる所がある。
Vendavel	ベンダベル	既存翻訳より
Balira	バリラ	人物名。風の魔法使いらしい
Nindiria	ニンディリア	カザイトの海賊であることを示す暗号のようなものらしい。語義としては「岸の丘」だそうな
nandipame	ナンディパメ	マンゲ語(中米のオトマンゲ語族の絶滅した言語)で「青」ないし「緑」
Nanzome	ナンゾメ	マンゲ語(中米オトマンゲ語族の絶滅言語)で「黒」
Rospa	ロスパ	Vendavelの3将軍の1人、Rospa Akiyuki。Eto Akiyukiに裏切られたらしく、首を欲しがっている。
Elatt	エラット	神様みたいな感じ？もとは人間だった？
Abrassar desert	アブラサール砂漠
Bourlamaque	ブラマク	人物名。モンスーンの枢機卿。
Ellinara	エリナラ	ギリシャ語。出典元が見つからなかったので音だけで仮に訳しています。後ほどインゲームの音を聞いてから最終決定したいです。
Mofat	モファット	人名。聖なる任務クエストで助けを求めている人の内のひとり。
Zephyrien	ゼフィリアン	人名。聖なる任務クエストで助けを求めている一人。チャンピオン？
Damian	ダミアン	人名。ダミアン・ロックウェル。モンスーンの代表者。リッサのモンスーン版。
Lockwell	ロックウェル	人名。ダミアン・ロックウェル。
Ziggurat Tunnel	ジグラットのトンネル
Burac Carillon	ブラックカリヨン	Cierzoの門衛
Burac	ブラック	Cierzoの門衛。Burac Carillon
Wendigo	ウェンディゴ	北米原住民アルゴンキン族の精霊。ウェンディゴは他の人には聞こえない声で後ろから話しかけるという。話しかけられた人は、徐々に彼らに近づいていき、最後には人を食べて完全なウェンディゴとなる。現在でも、アルゴンキンの末裔たちはウェンディゴになってしまうという恐怖から食人欲求を伴う精神病「ウェンディゴ症候群」にかかるという。
Kazite	カジート	船乗りの民族？
Amba	アンバ	カジート、船乗りの挨拶的なもの？
Cyrene	キュレネ	レバントにいる人？
Calixa	カリシア	レバントの女王？
Ash Giant	灰の巨人
Gold Belly	ゴールドベリー	灰の巨人の一人？
